NO ./input/sprites/texture1.xpm
SO ./input/sprites/texture2.xpm
WE ./input/sprites/texture5.xpm
EA ./input/sprites/texture4.xpm
C 100,200,255                
F 20,255,50

               11111111111111
               10000000000001
               10000000000001
               10000000000001
               10000000000001
               10000000000001
               10000000000001
111111111111111100000000000011111111111111111
100000000000000000000000000000000000000000001
100000000000000000000000000000000000000000001
1000000000000000000000N0000000000000000000001
100000000000000000000000000000000000000000001
100000000000000000000000000000000000000000001
111111111111111100000000000011111111111111111
               10000000000001
               10000000000001
               10000000000001
               10000000000001
               10000000000001
               10000000000001
               10000000000001
               11111111111111
