NO ./input/sprites/texture1.xpm
SO ./input/sprites/texture2.xpm
WE ./input/sprites/texture3.xpm
EA ./input/sprites/texture4.xpm
F 220,100,0 
	  C 225,30,0                  

		1111111111111111111111111
 11111  1000000000110000000000001
 101 1  1011000001110000000000001
 111    1001000000000000000000001
111111111011000001110000000000001
100000000011000001110111111111111
10000000000000001101010010001
11000001110101011111011110N0111
11110111 1110101 101111010001
11111111 1111111 111111111111
