NO ./sprites/texture1.xpm
SO ./sprites/texture2.xpm
WE ./sprites/texture3.xpm
EA ./sprites/texture4.xpm
F 220,100,0 
     C 225,30,0                  

               11111111111111
               10000000000001
               10000000000001
               10000000000001
               10000000000001
               10000000000001
               10000000000001
111111111111111100000000000011111111111111111
100000000000000000000000000000000000000000001
100000000000000000000000000000000000000000001
100000000000000000000000000000000000000000001
100000000000000000000000000000000000000000001
100000000000000000000000000000000000000000001
111111111111111100000000000011111111111111111
               10000000000001
               10000000000001
               10000000000001
               10000000000001
               10000000000001
               10N00000000001
               10000000000001
               11111111111111
